%%%%%%%%%%%
%   G     %
%  %   %  %
%  %   %  %
%  %   %  %
%         %
%    P    %
%         %
%         %
%  % % %  %
%  .      %
%%%%%G%%%%%
%%%%%%%%%%%