%%%%%%%%%%%%%%%%%%%%%%%%%%
%   G                    %
%  %   %                 %
%  %   %                 %
%  %   %                 %
%                        %
%    P          %%       %
%                %       %
%                        %
%  % % %    %   %        %
%  .                     %
%%%%%G%%%%%%%%%%%%%%%%%%%%
%%%%%%%%%%%%%%%%%%%%%%%%%%